worldtextures.png 20 20 32
000 000 000 000 000 000 000 000 000 000 000 000 000 000 000 000 000 000 000 000
000 200 200 200 200 200 200 200 200 200 200 200 200 200 200 200 200 200 000 000
000 200 200 200 200 200 200 200 200 200 200 200 200 200 200 200 200 200 200 000
000 200 200 200 200 200 200 200 200 200 200 200 200 200 200 200 200 200 200 000
000 200 200 200 200 200 200 200 200 200 200 200 200 200 200 200 200 200 200 000           
000 200 200 200 200 200 200 200 200 200 200 200 200 200 200 200 200 200 200 000
000 200 200 200 200 200 200 200 200 200 200 200 200 200 200 200 200 200 200 000
000 200 200 200 200 200 200 200 200 200 200 200 200 200 200 200 200 200 200 000
000 200 200 200 200 200 200 200 200 200 200 200 200 200 200 200 200 200 200 000           
000 200 200 200 200 200 200 200 200 200 200 200 200 200 200 200 200 200 200 000
000 200 200 200 200 200 200 200 200 200 200 200 200 200 200 200 200 200 200 000
000 200 200 200 200 200 200 200 200 200 200 200 200 200 200 200 200 200 200 000
000 200 200 200 200 200 200 200 200 200 200 200 200 200 200 200 200 200 200 000           
000 200 200 200 200 200 200 200 200 200 200 200 200 200 200 200 200 200 200 000
000 200 000 000 200 200 200 200 200 200 200 200 200 200 200 200 200 200 200 000
000 200 200 200 000 200 200 200 200 200 200 200 200 200 200 200 200 200 200 000
000 000 000 200 000 200 200 200 200 200 200 200 200 200 200 200 200 200 200 000           
000 000 000 200 000 200 200 200 200 200 200 200 200 200 200 200 200 200 200 000
000 400 200 200 000 200 200 200 200 200 200 200 200 200 200 200 200 200 200 000
000 000 000 000 000 000 000 000 000 000 000 000 000 000 000 000 000 000 000 000
